Zeit mit verbringt - spend time with
fast - almost
Bewohner - resident
zehlten - to camp
Einrichtung- Facility
unbedingt - absolutely
Vortrag - speech
machbar - double
Bedingung - condition
Geräusche - noise
Schnarchen - to shore
Stören + AKK, - to disturb
Unterhaltung - Entertainment
streiten + Akk. - to argue
Wie er/sie tickt - how he/she ticks
leisten - to afford
Röntgen - X-ray
es lohnt sich - it is worth it.
annehmen - to suppose
Arten - Varieties/types
vergrößern - enlarge
aussehen - to look like
Wie sieht es bei dir aus? - How is it looking for you?
bereit - ready
solche - such
Herkunft - origin
rücksicht - considerate
verwenden - to use/to utilize/to employ
Gehalt - salary
spielt eine große Rolle - plays a big role
ich bin hin und her gerissen - I am going here and there/back and forth
beweisen - to provide
jedenfall - anyway
Wert legen auf + AKK.- is important to me/value + something
Überstunden - overtime
unter Druck arbeiten - work under pressure
Sorge - worries
tätig sein als - employed as
dolmetschen - to interpret
Schichtarbeit + in Schichten arbeiten - Shift work, in shifts working
außer + Dativ- except
Leistung - Performance