ertragen - to bear (a person)
vertragen - to tolerate (a food/product)
Unverträglichkeit - intolerance (as food)
locker - easy
überschreiten - to transfer
Spannend - exciting
Wie lange hat die Reise gedauert - how long did the trip last?
Wovor - from what?
Vorhaben - to have for (to plan, to have plans)
Was hast du am Wochenende vor? (Vorhaben) -What do you have for the weekend?
begleiten - to accompany
Begleitung - Companion
Erholung - Relaxation
trampen, getrampt- to hitchhike
Unterkunft - accommodation
Sehenswürdigkeit- Sightseeing
Aussicht - Views
Bergspitze - Mountain peak
unterwegs - on the way
Ladekabel - charging cable
Fremder - Stranger
Tankstelle - Gas Station
erholsam - relaxing
erholen + Akk- to relax
abgefahren - incredible
reif - ripe
Ich bin sehr urlaubsreif - I'm very ready for a vacation. (ripe for vacation)
bewerten - to review
bemerken - to notice
Bekanntschaft - acquaintance
in der nähe von, bei - in the vicinity of
ansprechen + Akk - to address
Er hat mich angesprochen - He addressed me.
Gastarbeiter - guest worker /works in a country for 2-3 years, usually blue collar)
Strand Kunstwerk - beach artwork
aufbauen - to build up
Grund, wofür - reason why
Verreisen - to travel for a short time
Schritte - Steps
ingesamt - in total
Meiner Meinung nach - in my opinion (never In meine Meinung)
hübsche - good-looking
bedeutend - meaningful
berühmte - famous
Hügel - hills
rückwärts - backwards
überlaufen - crowded
faul - lazy
Pflicht - duty
verpflichten + AKK - to commit oneself.
Verpflichtung - Obligation
verpflichtet- obligated/committed
Pflege - care
Freiwilliges soziales Jahr (FSJ) - Voluntary social year
Überzeugung- conviction
Schutz - protection
Betreuung - Care
Gesetz - law
Redemittel - figure of speech
Ziemlich - quite/more or less
Mond - Moon
klüger - smarter
Wolke - Cloud