Angestellte- employees
knapp - almost (precisely a few, less than ungefähr)
Weil - while
Voraussetzungen - prerequisites
lösen - to solve
folgenden - following
einteilen - to organize
weitgehend - largely
Eigenverantwortung - personal responsibility
zufrieden - Satisfied
Baumwolle + e- cotton
weich - Soft
tatsächlich - actually
Rutsch + r - Slide
Ischias - sciatica
Entspannung - relaxation
spitz - sharp
tun - do
tun weh - to hurt
es tut weh - it hurts
Spezifität + e - specificity
zuletzt - most recently
flach - flat/shallow
dünn - thin
dick - thick
glatt - Smooth
rau - rough
empfindlich - Sensitive/delicate
zerbrechlich - fragile
stabil - sturdy/stable
eckig - Square, angular
platzsparend - Compact/space-saving
sperrig - large/bulky
Ich bin genauso wie du - I am just like you!
Mir geht es genauso wie dir - It goes for me just like it does for you.
gebraucht - second-hand/used
es kommt nicht oft vor - it doesn't happen often
Sie hatten in der zeit - Stood the test of time
Einselkind + S - only child
übertragen - pass on/transmit
woraus - out of where/what?
verbrauchen - to consume
gleichzeitig - simultaneously
kiffen - to smoke weed
Hanfplanze + e - hemp
Mülltonne + e - large trash can
Kaffeesatz - coffee grounds
entstehen + durch, Akk, - to originate from
Geschirr - dishes (more general than Gerichte)
giftigen - poisonous
vergiften - to poison
vermeiden - to avoid
leidtun - to pity/to feel sorry for
wasserfest - waterproof
wasserdicht - water resistant