Auszeit - time off
vor allem - especially
friedliche - peaceful
Unterkunft - Accommodation
besetzen - to occupy
bewundern - to admire
Risiko - risk
fest angestellt sein - be permanently employed
ein Risiko eingehen - to take a risk
etwas Neues wagen - dare to try something new
Erfahrungen sammeln - to collect experiences
eine Idee umsetzen - to implement an idea
einen Traum verwirklichen- to realize a dream
einen Auftrag bekommen - to receive an order
aufnehmen + AKK- to take something (like a photo or video)
zuschauen - to spectate
überreden - to convince
Heiratsantrag - marriage proposal
üblich - common
Gesichtspunkt - point of View
Ausnahme - exception
kündigen - to quit
entlassen - to dismiss
ein Ziel erreichen - to reach a goal
erreichen- to reach
Überfordert- overwhelming
verteilen - to distribute
er trifft die Entscheidung - he meets a decision (German uses treffen in this context)
loswerden - to get rid of
zufällig - accidentally/by chance
schützen vor + Dat. - to protect from
immerhin - after
Ich kenne mich sehr gut aus - I have very good knowledge of
Ich kenne mich gar nicht aus - I have really no knowledge of
ich bin dabei - I will be there
ich bin am Start - I can't wait
dabei - included/there/yet/at that
darauf - on it/thereon/thereafter/at that
obwohl + auch wenn - although
Gabe - talent
schüchtern sein - to be shy
unerträglich - unbearable
dafür bin ich nicht zuständig - I am not responsible for that
Vorschriften - regulations
ziemlich - quite
Gefängnis - prison
Abläufen - processes
neulich - recently
meiner Meinung nach - in my opinion