berührend - touching
Verfassung - Constitution
Bürger + Bürgerin - citizen
Jahrzehnten - century
raten - to advise/to guess
Ich stimme dir zu - I agree with you
Dem stimme ich nicht so ganz - I don't quite agree with that
Das kann ich gut nachvollziehen - I can relate well with that
Ich bin der Meinung, dass...- I am of the opinion, that...
Das Stimmt.... aber.... Meiner Meinung nach... - It's true that... but... my opinion is..-
Gedicht - poem
absagen + Dat. - to cancel
Zutritt - access, entry
Zettel - note
dabei - included
sinnlos - pointless/senseless
erzählen von - to tell about
Sich kümmern um + AKK. - to care about something
widersprechen - to contradict
unterbrechen - to interrupt
Lass mich bitte Kurz ausreden - Let me finish speaking, please
Burgermeister- Mayor
weiterhin - furthermore
leiten - to lead
dringend - urgent
Sachen - things
Das sehe ich auch so - That's how I see it too
Da hast du recht - You're right
Das sehe ich völlig anders - I see it completely differently
Das kann ich mir gut vorstellen - I can well imagine that
Da bin ich ganz anderer Meinung - I have a completely different opinion
Versteh mich nicht falsch, aber... - Don't get me wrong, but...
Da bin ich mir aber nicht so sicher - But I'm not so sure about that
Ich bin ganz deiner Meinung - I completely agree with you
Da muss ich widersprechen - I have to disagree
Darf ich direkt etwas dazu sagen? - Can I say something directly?
Lass mich bitte kurz ausreden - Please let me finish for a moment
Ich möchte dazu etwas argänzen - I would like to add something
Entschuldigung, wenn ich unterbreche, aber... - I apologize if I'm interrupting, but...
Einen Moment bitte, ich möchte nur noch kurz sagen... - One moment please, I would just like to say a few words...