Aufgeschossen - Open-minded
gesellig - sociable
angebunden-connected
Überraschung- Surprise
reagieren - react
jemanden - Someone
ankommen auf - Depends on
abhängen von - Depends on
trauen - to dare
Stimmung - mood
Vorstellen - introduce
Vergangenheit- the past
erwachsen - adult
beobachte - to observe
Wünschen - to wish
Gemeinsamkeiten- Similarities
Zukunftiger - future
wechseln - to change
Fernbeziehung - long-distance relationship
gefehlt - missing
Herausforderung - challenge
Herausfordernd - challenging
träumen - to dream
erlebnis - experience
verändern - to change
Hund und Torte - idiom depicting conflict
riechen - to smell
duften - to smell good geduftet
stinken - to smell bad gestinken
verbinden- connected
verbunden- tied together
vergleicht - to compare
bestätigen - to confirm
wecken - to awake
gegenteil - opposite
Gefahren - hazards
sich vorstellen - to imagine
Zwingen - to Command
während - during
Abenteuer- adventure