vorbereiten - To prepare in advance (a day or many hours before)
zubereiten - to prepare immediately before something
Hintergrundschirm - background
Zutat + Zutaten - ingredient
Nudelholz- rolling pin
den Teig ausrollen - to roll out the dough
Plätzchen - Cookies
Bericht - report
Abschiedsgeschenk- Farewell gift
Geschenk - gift
Abschiedsparty-farewell party
begrüßtig - convenient
Abschussbericht - final report
überfliegen - to skim
Dozent - lecturer
Vorlesung - lecture (only in university context)
Voraussetzungen - requirements
Tippfehler - typo
Unterkunft - accommodation
Veranstaltung - event
Begrüßungsritual - Welcoming ritual/Orientation
Unterrichtsstil - teaching style
durchlesen- to read carefully
mündlicher - oral
schriftlicher - written
übrigens - by the way
schrecklich - horrible
Stolz - proud
lügen + gelogen - to lie
vielfältig - valuable
Erwartung- expectation
Wegen + Gen. Präposition - because of
trotz + Gen. Präposition - in spite of
um zwar - in order to
aus persönlichen Gründen - for personal reasons
ungewohnten - unusual
Was magst du an...? - what do you like about...?
Vorschlag + Vorschläge - Suggestion