Umfrage - Survey
Zur Verfügung gestellt (stellen)- I am at your disposal
Umstieg - change from one thing to another
Hälfte - half
Aussage - Statement
Teilnehmer - Participant
fuhren - fahren (präteritung)
Umstieg - the change from one thing to another
gezeigt + Zeigen - shown, to show
freiwillig - Voluntarily
Ausrüstung - equipment
leihen - to rent
teilnehmen an + teilgenommen, dativ - to participate
erklären - to explain (to make clear)
Aufmerksamkeit - attention/consideration
Anmerkungen - remarks
Es geht um + AKK. - It is about...
Nutzung - use
herausfinden + herausgefunden - to find out
Geschwindigkeit - speed
Einschätzung - estimate
die Zeit ist um - the time is up
Ich hatte mich an die Regel - I follow the rule
Überschreiben + überschritten- go over
erreichen - to reach a place
anspornen- to encourage
Stau - traffic jam
Wo befindet sich - Where is it found
im Stau stecken- stuck in traffic
dauern - to last
unabhängiger + von mit Dativ - independent, or independent from
beibringen - to teach
Landwirtschaft - agriculture
Landschaft - landscape
Schafe - sheep
Löwe - lion
Hase - hare
Affe - monkey
Ente - duck
Fliege - fly (bug)
Mücke - mosquito
Krokodil - crocodile
Schildkröte - tortoise
Zeltplatz- campsite
Dorf - village
Dorfladen- village shops
Versammlungsraum - meeting room (large ≥ 50 people)
Fortbildungzentrum - education center
Fortbildung - certification course
Wir ziehen aufs Land - We will move to the countryside.
schiess los - tell me more!
bei mir auch viel los - I have also a lot going on
Es hört sich gut an/anstrengend an - that sounds good/too much
anhören - to listen
ernähren + mich, reflexiv - to nourish oneself
tauchen - to dive